#######################################
# Syntax Coloring Map For Mooglesp
#######################################
# Class (KEYWORD1)
#######################################

Mooglesp_AnalogIO	KEYWORD1
Mooglesp_Button	KEYWORD1
Mooglesp_DHT	KEYWORD1
Mooglesp_Led	KEYWORD1
Mooglesp_LM75	KEYWORD1
Mooglesp_MHZ19	KEYWORD1
Mooglesp_Pin	KEYWORD1
Mooglesp_RGBLed	KEYWORD1

#######################################
# Methods and Functions (KEYWORD2)
#######################################

analogRead	KEYWORD2
analogReadSmooth	KEYWORD2
analogWrite	KEYWORD2
begin	KEYWORD2
blink	KEYWORD2
clear	KEYWORD2
configureAutoCalibration	KEYWORD2
configureSpanCalibration	KEYWORD2
digitalRead	KEYWORD2
digitalWrite	KEYWORD2
enableZeroCalibration	KEYWORD2
fade	KEYWORD2
getAutoCalibrationStatus	KEYWORD2
getCO2	KEYWORD2
getColor	KEYWORD2
getColorBlue	KEYWORD2
getColorGreen	KEYWORD2
getColorRed	KEYWORD2
getData	KEYWORD2
getFirmwareVersion	KEYWORD2
getHumidity	KEYWORD2
getHysteresis	KEYWORD2
getMode	KEYWORD2
getOverTemperature	KEYWORD2
getPinNumber	KEYWORD2
getRX	KEYWORD2
getTemperature	KEYWORD2
getTX	KEYWORD2
getValue	KEYWORD2
isPressed	KEYWORD2
isReleased	KEYWORD2
isWarmingUp	KEYWORD2
off	KEYWORD2
on	KEYWORD2
rainbow	KEYWORD2
read	KEYWORD2
setColor	KEYWORD2
setFrequency	KEYWORD2
setHysteresis	KEYWORD2
setInputTime	KEYWORD2
setMode	KEYWORD2
setOverTemperature	KEYWORD2
setPinNumber	KEYWORD2
setResolution	KEYWORD2
setRX	KEYWORD2
setSampleSize	KEYWORD2
setTX	KEYWORD2
state	KEYWORD2
wasPressed	KEYWORD2
wasReleased	KEYWORD2

#######################################
# Constants (LITERAL1)
#######################################

MOOGLESP_DHT_DATA_INVALID	LITERAL1
MOOGLESP_DHT_DATA_PULSES	LITERAL1
MOOGLESP_DHT_DATA_SIZE	LITERAL1
MOOGLESP_DHT_TYPE_DHT11	LITERAL1
MOOGLESP_DHT_TYPE_DHT12	LITERAL1
MOOGLESP_DHT_TYPE_DHT21	LITERAL1
MOOGLESP_DHT_TYPE_DHT22	LITERAL1
MOOGLESP_LM75_REGISTER_TEMPERATURE	LITERAL1
MOOGLESP_LM75_REGISTER_CONFIGURATION	LITERAL1
MOOGLESP_LM75_REGISTER_THYST	LITERAL1
MOOGLESP_LM75_REGISTER_TOS	LITERAL1
MOOGLESP_RGBLED_COLOR_BLACK	LITERAL1
MOOGLESP_RGBLED_COLOR_BLUE	LITERAL1
MOOGLESP_RGBLED_COLOR_CYAN	LITERAL1
MOOGLESP_RGBLED_COLOR_GREEN	LITERAL1
MOOGLESP_RGBLED_COLOR_MAGENTA	LITERAL1
MOOGLESP_RGBLED_COLOR_RED	LITERAL1
MOOGLESP_RGBLED_COLOR_WHITE	LITERAL1
MOOGLESP_RGBLED_COLOR_YELLOW	LITERAL1
